#############
#x         O#
#     #     #
#y    !  I  #
#           #
#############

! left
x right turn-right
