#############
#x         f#
#     #     #
#     !  f  #
#           #
#############

! left
x right turn-right
