#############
#x          #
#     #     #
#        f !#
#############

! left
x right turn-right
