First map
#############
#x O        #
#     #     #
#     !  I  #
#           #
#############

! left
x right turn-right
