First map
#############
#x O        #
#     #     #
#  R  !  I  #
#           #
#############

! left
x right turn-right
