#############
#x         O#
#     #     #
#     !  I  #
#           #
#############

! left
x right turn-right
