Strange map
######  ####
#0    ##   1#
##     O   #
 #### E   #
   #  !  #
   #  R  #
   #######

0 right turn-right
1 left turn-left
! left E R
