Signature
            ##########
#############c     ###############
# !      O                   A  ##############
##############              E                 ##
           #      #####                         ##
           #      #    #        a          RR     ##
           #b     #     ##############################
           #      #     #     #  #  ###  #   ###
           #     ##    # #   #  #  ###  #    #
           #######    #   # #  #  #    #     #
                     #     #  #  ###  ###  ###

! right
a right turn-down U
b right turn-left
c right turn-right
