Evil
#####################
# #               # #
#  #             #  #
#   #           #   #
#    #         #    #
#     #       #     #
#      #     #      #
# z     #   #       #
#        #          #
#         #         #
#          #        #
#           #       #
#   O ! L    #      #
#             #     #
#       A      #  R #
#               #   #
#  x      y      #  #
#C                # #
#                   #
#####################

! down A R
x right turn-left
y right turn-right
z right turn-down O
